Stage 1
#####
#OoP#
#####
=====
Stage 2
  #######
###  O  ###
#    o    #
# Oo P oO #
###  o  ###
 #   O  # 
 ########
===========
Stage 3
######
#P  ##
#Oo0 #
#  # #
#    #
######
======
Stage4
###### 
#P   ##
# oo  #
# #O O#
#     #
#######
=======
Stage5
  #### 
###  # 
#P Oo##
#   o #
# #O  #
#     #
#######